WWWWWWWWWWWWWWWWWWWWWWWW
WGGGGGGGGGGGGGGGGGGGGGWW
WGGGGGGGGGGGGGGGGGGGGGGW
WGGGGGGGGGGGGGGGGGGGGGGW
WGGGGGGGGGGGGGOOGGGGGGGW
WGGGGGGGGGGGGGGGGGGGGGGW
WGGGGGGGGGGGGGGGGGGGGGGW
WGGGGGGGMMMGGGGOGGGGGGGW
WGGGGGGGGGGGGGGGGGGGGGGW
WGGGGGGGGGGGGGGGGGGGGGGW
WGGGGGGGGGGGGGGGGGGGGGGW
WGGGGGGGGGGGGGGGGGGGGGGW
WGGGGGOOOOOOOOOOOOGOOOOW
WGGGGGGGGGGGGGGGGGGGGGGW
WGGGGGGGGGGGGGGGGGGGGGGW
WGGGGGGGGGGGGGGGGGGGGGGW
WGGGGGGGGGGGGGGGGGMMMGGW
WWWWWWWWWWWWWWWWWWWWWWWW